12 12
############
#E         #
########## #
#          #
# ##########
#          #
########## #
#          #
# ##########
#         =#
############
            
